33,33,04,34,18,06,08,08,07,33
17,17,17,11,34,00,31,34,22,22
21,28,28,04,11,26,31,34,22,22
21,34,34,28,34,26,31,26,34,34
21,27,21,34,34,31,31,23,34,22
21,24,05,24,24,13,31,23,22,16
01,04,32,32,36,13,31,26,22,19
01,24,03,32,27,25,31,35,29,20
21,24,21,27,32,35,21,22,26,15
21,02,09,14,10,35,30,12,33,15
