01,01,05,05,10,01,01,01
01,09,07,07,03,01,01,01
01,00,02,02,04,03,01,01
01,00,06,08,01,01,01,01
01,01,01,01,01,01,01,01
01,01,01,01,01,01,01,01
16,16,16,16,12,14,11,15
13,11,13,16,12,14,14,15
